R 900	700
NO ./img/wall_n.xpm
SO ./img/wall_s.xpm
WE ./img/wall_w.xpm
EA ./img/wall_e.xpm
S ./img/purple_s.xpm


C 100,100,100
F 150,150,150


1111111111111111111111111111111111111
1000000000000000000000000000000000001
100000000000000000000000000000N000001
1000000000000000000000000000000000001
1000000000000000000000000000000000001
1000000000000000000000000000000000001
1000000000000000000000000000000000001
1000000000000000000000000000000000001
1000000000000000000000000000000000001
1000000000000000000000000000000000001
1000000000000000000000000000000000001
1000000000000000000000000000000000001
1000000000000000000000000000000000001
1000000000000000000000000000000000001
1000000000000000000000000000000000001
1000000000000000000000000000000000001
1000000000000000000000000000000000001
1000000000000000000000000000000000001
1000000000000000000000000000000000001
1000000000000000000000000000000000001
1000000000000000000000000000000000001
1111111111111111111111111111111111111
