R 900	700
NO ./img/pack_n.xpm
SO ./img/pack_s.xpm
WE ./img/pack_w.xpm
EA ./img/pack_e.xpm
S ./img/pack_sp.xpm

F ./img/pack_n.xpm
C ./img/pack_e.xpm


111111111111111
110000000000001
100000000020001
100000300000001
100000000000001
100000N00000001
103000000020001
100000000000001
100000001000001
111111111111111
