R 640 480
NO ./img/wall_n.xpm
SO ./img/wall_s.xpm
WE ./img/wall_w.xpm
EA ./img/wall_e.xpm

S ./images/ITEM.xpm
F 00,153,15
C 255,255,255

1111111111
1100000001
1000000001
1000000001
1000000001
1000000001
1000000001
1000000001
1000000001
1111111111
