R 900	700
NO ./img/pack_n.xpm
SO ./img/pack_s.xpm
WE ./img/pack_w.xpm
EA ./img/pack_e.xpm
S ./img/pack_sp.xpm

F ./img/eagle.xpm
C ./img/colorstone.xpm


111111111111111
110000000000001
100003000000001
100000000000001
100000000000001
100000N00000001
100000000000001
100000000000001
100000001000001
111111111111111
