R 640 480
NO ./img/wall_n.xpm
SO ./img/wall_s.xpm
WE ./img/wall_w.xpm
EA ./img/wall_e.xpm

S ./images/ITEM.xpm
F 15,153,15
C 200,200,200

111111111111111
110000000000001
100000000000001
100000000000001
100000S000000001
100000000000001
100000000000001
100000000000001
100000000000001
111111111111111
