R 900	700
NO ./img/wall_n.xpm
SO ./img/wall_s.xpm
WE ./img/wall_w.xpm
EA ./img/wall_e.xpm
S ./img/pack_sp.xpm

C ./img/bluestone.xpm
F ./img/colorstone.xpm

111111111111111111111111111111111111111111111
110000000000000000000000000000000000000000001
100003000000000000000000000000002000000000001
100000000000000000003000000000003000000000001
100000000000000000000000000000020000000000001
100000E00000000000000003000000000000000000001
100000000000002000000000000000000002000000001
100000000000000000000000000000000000000000001
100000001000000000000000000000000000000000001
100000000000000000000000000000000000000000001
100000000000000000000000000000000000000000001
100000000000000000000000000200000000000000001
100000000000000000000000000000000000000000001
100000000000000000000000000000000000000000001
111111111111111111111111111111111111111111111
