111111111111111
110000000000001
100300000000001
100000200000001
100000000000001
100000N00000001
100000000000001
100000000000001
100000001000001
111111111111111
