111111111111111
110000000000001
100200000000201
100000200000001
100000000000001
100000N00000001
100000000000201
100000000000001
100000001000001
111111111111111
